----------------------------------------------------------------------------------------------------|
|                       |                           |           |                   |               |
--------------------|   --------|   ------------|   ----|   |   |   --------|   |   ------------|   |
|   |               |               |               |       |   |           |   |                   |
|   |   |   ------------------------|   ------------|   ----|   ------------|   ----------------|   |
|   |   |                           |   |           |       |           |       |           |       |
|   |   --------------------|   ----|   |   ----|   |   |   --------|   |   --------|   |   |   ----|
|       |       |               |       |   |       |   |           |   |   |           |   |   |   |
|   ----|   |   |   --------|   |   ----|   |   ----|   --------|   |   |   |   ------------|   |   |
|       |   |   |       |       |   |       |   |           |       |   |   |   |               |   |
----|   |   |   ----|   --------|   |   ----|   ------------|   ----|   |   |   |   ------------|   |
|   |       |       |           |   |       |               |       |       |                       |
|   ------------|   --------|   |   |   |   ------------|   |   |   ----------------|   --------|   |
|                       |       |   |   |           |   |   |   |           |       |   |       |   |
------------------------|   ----|   |   --------|   |   |   ------------|   |   |   |   |   |   ----|
|               |       |   |       |   |   |       |   |   |       |       |   |   |   |   |       |
|   --------|   |   |   |   |   ----|   |   |   ----|   |   |   |   |   ----|   |   |   |   ----|   |
|   |       |       |       |       |   |   |       |           |       |       |   |   |       |   |
|   |   |   --------------------|   |   |   ----|   ----------------|   |   ----|   |   ----|   |   |
|       |                   |       |       |   |                   |   |       |   |   |       |   |
|   --------------------|   |   --------|   |   ----------------|   --------|   |   ----|   ----|   |
|       |               |       |           |                   |   |       |   |           |       |
----|   ----|   ----|   --------|   --------|   ------------|   |   |   |   |   ------------|   |   |
|       |       |       |       |               |               |       |                   |   |   |
|   ----|   ----|   ----|   |   ------------------------------------------------------------|   |   |
|           |               |                                                                   |   |
----------------------------------------------------------------------------------------------------- 🚪 