--------------------|
|           |       |
--------|   |   |   |
|           |   |   |
|   --------|   |   |
|   |           |   |
|   ----|   ----|   |
|       |   |       |
----|   |   |   ----|
|           |       |
--------------------- 🚪 