------------------------------------------------|
|   |               |                       |   |
|   |   --------|   |   ----------------|   |   |
|       |       |       |       |       |   |   |
--------|   ------------|   |   ----|   |   |   |
|   |                       |           |       |
|   |   ------------|   |   ----------------|   |
|       |       |   |   |   |       |       |   |
|   ----|   |   |   |   ----|   |   |   |   |   |
|   |       |   |   |           |       |   |   |
|   |   ----|   |   --------------------|   |   |
|       |                               |       |
------------------------------------------------- 🚪 