------------------------------------------------|
|       |                   |       |           |
----|   ------------|   |   |   |   |   |   |   |
|   |                   |   |   |   |   |   |   |
|   --------------------|   |   |   ----|   ----|
|               |       |       |       |       |
|   |   ----|   |   |   ------------|   |   |   |
|   |       |   |   |           |       |   |   |
|   ----|   ----|   --------|   |   --------|   |
|       |       |   |       |       |           |
----|   ----|   |   |   |   --------|   ----|   |
|           |           |               |       |
------------------------------------------------- 🚪 