--------------------------------------------------------------------------------------------------------------------------------------------------------------------------------------------------------|
|   |                           |               |       |                   |       |       |       |                   |               |       |           |                                       |   |
|   ----|   --------|   |   ----|   |   ----|   |   |   ----|   ----|   |   |   ----|   |   |   |   |   ----|   ----|   ----|   ----|   |   |   |   ----|   |   ----------------|   ------------|   |   |
|       |   |       |   |           |       |       |       |       |   |   |       |   |       |   |       |   |           |       |       |   |       |   |   |           |       |       |   |   |   |
----|   ----|   |   ------------|   ----|   ------------|   --------|   |   ----|   |   --------|   ----|   |   --------|   |   |   ------------|   ----|   |   |   ----|   |   ----|   |   |   |   |   |
|   |           |               |       |   |           |   |           |       |           |   |       |   |           |   |   |                   |       |       |   |   |   |       |       |       |
|   ------------------------|   --------|   |   --------|   |   ------------|   --------|   |   ----|   |   --------|   |   --------|   ------------|   ------------|   |   |   |   --------|   ----|   |
|                       |       |           |   |           |       |           |       |           |       |   |       |           |   |           |                   |   |   |       |           |   |
|   ----------------|   |   ----|   --------|   |   --------|   |   --------|   |   |   --------|   --------|   |   ------------|   |   |   |   |   ------------|   ----|   |   ----|   ------------|   |
|           |       |       |       |               |       |   |           |       |   |           |           |   |               |   |   |   |       |           |       |       |                   |
--------|   |   ------------|   ------------|   ----|   |   --------|   |   --------|   --------|   ----|   ----|   |   ------------|   ----|   ----|   |   --------|   --------|   |   ----------------|
|       |   |               |   |           |           |           |   |       |               |           |       |   |   |                   |       |                       |   |           |       |
|   ----|   |   |   ----|   |   |   ----|   --------------------|   --------|   ------------|   --------|   |   ----|   |   |   --------|   ------------|   --------------------|   --------|   ----|   |
|       |   |   |   |   |   |           |               |       |   |       |           |               |   |   |       |       |       |   |           |       |               |       |   |       |   |
|   |   |   |   |   |   |   --------|   ------------|   |   |   |   |   |   --------|   ------------|   ----|   |   ----|   ----|   |   ----|   ----|   --------|   --------|   ----|   |   ----|   |   |
|   |       |   |   |   |           |               |       |   |       |           |       |       |           |       |   |       |   |       |   |   |           |           |       |   |       |   |
|   --------|   |   |   --------|   ------------------------|   ----------------|   ----|   ----|   ----------------|   |   |   ----|   |   ----|   |   |   --------|   --------|   ----|   |   ----|   |
|   |           |   |   |       |                       |       |       |       |           |       |               |   |   |   |   |   |       |   |   |           |               |       |       |   |
|   ------------|   |   |   |   --------------------|   |   ----|   |   |   |   ------------|   ----|   |   ----|   |   ----|   |   |   ----|   |   |   ----|   |   ----------------|   --------|   |   |
|   |           |   |       |               |       |   |           |   |   |       |                   |       |   |   |       |       |       |   |       |   |   |       |       |       |       |   |
|   |   ----|   |   |   ----|   --------|   |   |   |   ------------|   ----|   ----|   --------------------|   ----|   |   ----|   ----|   ----|   ----|   ----|   |   |   |   |   |   |   |   ----|   |
|   |       |       |   |       |       |   |   |   |                   |       |       |                   |       |       |       |       |           |       |   |   |   |   |   |   |   |   |       |
|   |   |   ------------|   |   |   |   ----|   |   --------------------|   ----|   ----|   ----|   ----|   ----|   --------|   ----|   ----|   ------------|   |   |   ----|   |   |   |   |   |   |   |
|   |   |   |               |   |   |           |                       |           |       |       |       |           |       |       |                   |       |           |   |   |   |   |   |   |
|   ----|   |   |   ------------|   --------------------|   ------------|   --------|   ----|   ------------|   |   ----|   ----|   |   |   ------------|   --------|   --------|   |   |   |   ----|   |
|           |   |   |                       |               |           |   |           |       |               |   |       |       |   |               |           |           |       |   |       |   |
------------|   |   |   --------------------|   --------|   |   ----|   |   |   --------|   |   |   ----|   --------|   ------------|   ------------------------|   --------|   --------|   ----|   |   |
|       |       |   |           |               |           |   |   |       |       |       |   |   |       |       |   |           |   |                       |           |   |   |           |   |   |
|   ----|   |   --------|   ----|   ----------------|   ----|   |   ------------|   |   --------|   --------|   |   |   |   ----|   |   |   ----------------|   |   |   ----|   |   |   |   ----|   |   |
|   |       |               |       |       |       |   |   |   |               |   |           |               |   |       |   |       |   |               |   |   |   |           |   |   |       |   |
|   |   --------------------|   |   |   |   |   |   |   |   |   ----|   --------|   --------|   ----------------|   --------|   --------|   |   ----|   ----|   |   |   |   --------|   |   |   ----|   |
|   |   |           |       |   |   |   |       |   |       |   |       |       |       |   |           |       |                   |       |       |       |       |   |   |           |   |   |       |
|   |   |   ----|   ----|   |   |   |   --------|   --------|   |   ----|   |   ----|   |   |   ----|   |   ----|   ------------|   |   |   ----|   ----|   --------|   |   |   --------|   |   ----|   |
|   |       |   |       |   |   |   |   |       |               |       |   |           |   |   |   |   |       |               |   |   |   |       |   |       |       |   |           |   |           |
|   --------|   ----|   |   |   ----|   |   ------------------------|   |   ------------|   |   |   |   ----|   ------------|   |   ----|   |   ----|   ----|   |   ----|   --------|   |   --------|   |
|           |       |   |   |           |   |           |           |       |               |   |   |   |       |       |       |       |   |       |   |       |       |       |       |   |           |
----|   |   |   ----|   |   ------------|   |   |   |   |   ----|   |   ----|   ----|   ----|   |   |   |   |   |   |   |   --------|   |   ----|   |   |   --------|   ----|   |   --------|   --------|
|       |   |       |   |                   |   |   |   |   |       |   |       |       |       |           |   |   |   |   |               |           |   |       |       |   |               |       |
|   ----|   ----|   |   ------------|   |   |   |   |   |   ----|   |   ----|   --------|   |   ----------------|   |   |   ----------------------------|   |   |   ----|   |   ----------------|   ----|
|   |   |   |       |       |       |   |       |   |   |       |   |       |           |   |   |                   |   |   |                           |       |           |           |               |
|   |   |   |   |   ----|   |   |   |   --------|   |   ----|   |   ----|   --------|   |   ----|   ----------------|   |   |   --------------------|   |   ------------------------|   ------------|   |
|   |           |   |   |       |   |           |   |           |       |           |   |       |   |       |           |   |   |               |       |   |                   |       |               |
|   ------------|   |   --------|   ------------|   ----------------|   --------|   |   ----|   |   |   ----|   ----|   |   |   --------|   |   |   ----|   ----|   ----|   |   |   ----|   --------|   |
|           |           |       |   |           |               |   |       |   |           |           |       |       |   |           |   |   |   |   |       |       |   |   |           |       |   |
|   ----|   |   --------|   |   |   |   ----|   ------------|   |   ----|   |   |   ------------|   ----|   ----|   ----|   --------|   |   |   |   |   ----|   --------|   |   ------------|   |   |   |
|   |   |   |       |       |       |   |               |       |   |       |       |           |   |       |   |   |   |   |           |   |   |   |                       |       |           |   |   |
|   |   |   --------|   ------------|   ------------|   |   ----|   |   ----|   ----|   ----|   |   |   ----|   |   |   |   |   ------------|   |   ----------------------------|   |   ----|   ----|   |
|       |               |           |       |           |   |           |           |   |       |   |   |       |   |   |   |                   |   |       |                   |   |   |   |       |   |
----|   --------------------|   |   ----|   |   --------|   |   --------------------|   |   --------|   |   |   |   |   |   ----------------|   |   |   |   |   ------------|   ----|   |   ----|   |   |
|                               |           |               |                           |               |   |           |                       |       |                   |                   |       |
--------------------------------------------------------------------------------------------------------------------------------------------------------------------------------------------------------- 🚪 