------------------------------------------------|
|               |           |                   |
------------|   |   ----|   ----|   --------|   |
|           |   |       |           |       |   |
|   --------|   ----|   ----------------|   |   |
|           |       |   |                   |   |
|   ----|   ----|   |   ----|   --------|   |   |
|   |   |       |       |       |       |   |   |
|   |   |   |   --------|   ----|   |   ----|   |
|       |   |               |       |           |
----|   |   ----------------|   ----------------|
|       |                                       |
------------------------------------------------- 🚪 