----------------------------------------------------------------------------------------------------|
|           |                       |       |       |       |                           |           |
--------|   --------|   ----|   |   |   |   |   |   ----|   |   |   ----------------|   |   ----|   |
|           |       |   |       |       |   |   |       |       |               |       |       |   |
|   --------|   |   ----|   ------------|   |   ----|   |   ----------------|   |   ------------|   |
|       |       |           |           |   |   |   |   |   |           |       |       |       |   |
----|   ----|   ------------|   --------|   |   |   |   |   |   ----|   |   --------|   |   |   |   |
|   |       |       |                       |   |       |   |   |       |   |       |       |       |
|   ----|   ----|   --------|   ------------|   |   --------|   |   ----|   |   |   ------------|   |
|       |       |           |           |       |               |   |       |   |               |   |
|   --------|   |   ----|   --------|   ----|   ----------------|   ----|   |   ------------|   |   |
|               |       |       |   |       |       |           |       |   |       |       |   |   |
|   ------------------------|   |   ----|   ----|   |   |   --------|   |   ----|   ----|   |   |   |
|           |           |       |   |       |       |   |       |       |   |   |           |       |
--------|   ----|   |   |   ----|   |   ----|   ------------|   |   ----|   |   --------|   --------|
|       |           |   |   |       |           |           |   |   |       |           |   |       |
|   |   ------------|   |   |   ----------------|   ----|   |   |   ----|   ----|   |   |   |   |   |
|   |   |           |       |               |           |   |   |       |       |   |   |   |   |   |
|   |   |   ----|   --------|   |   --------|   ----|   |   |   ----|   ----|   ----|   |   |   |   |
|   |   |   |   |               |               |   |   |           |       |   |       |   |   |   |
|   ----|   |   --------------------------------|   |   ----|   --------|   |   |   |   |   |   ----|
|           |                           |           |   |       |       |       |   |   |   |       |
|   ----------------------------|   |   |   |   ----|   |   ----|   |   --------|   ----|   |   |   |
|       |                       |   |       |   |       |   |       |       |           |   |   |   |
----|   |   ----------------|   ------------|   |   --------|   ----|   ----|   ----|   |   ----|   |
|           |                                   |                   |               |               |
----------------------------------------------------------------------------------------------------- 🚪 