----------------------------------------------------------------------------------------------------|
|               |           |       |                           |       |               |           |
------------|   ----|   |   ----|   |   ----------------|   |   ----|   |   |   --------|   |   |   |
|           |   |       |   |       |       |           |   |           |   |           |   |   |   |
|   |   |   |   |   ----|   |   --------|   |   ----|   |   ----|   ----|   --------|   |   |   |   |
|   |   |   |       |   |   |               |   |           |       |       |       |       |   |   |
|   |   |   --------|   |   --------|   ----|   --------------------|   ----|   |   --------|   |   |
|   |   |       |       |           |       |   |               |               |           |   |   |
|   |   |   ----|   |   --------|   ----|   |   |   --------|   |   --------------------|   |   ----|
|   |   |   |       |       |       |       |       |           |       |               |   |       |
|   |   ----|   --------|   |   --------------------|   ------------|   |   --------|   --------|   |
|   |           |           |           |           |       |       |   |           |               |
|   ------------|   |   ------------|   |   ----|   |   |   |   |   |   --------|   ----------------|
|   |           |   |   |           |   |   |       |   |       |   |           |   |               |
|   |   ----|   |   ----|   ----|   |   |   |   ----------------|   --------|   |   |   --------|   |
|   |   |   |   |       |       |   |   |   |           |       |               |       |       |   |
----|   |   |   ----|   |   ----|   |   |   --------|   |   |   |   --------------------|   |   |   |
|       |               |   |       |   |   |       |       |   |   |       |               |   |   |
|   ----|   ------------|   |   ----|   |   |   |   --------|   ----|   |   |   ------------|   |   |
|   |   |   |           |   |       |   |       |   |       |           |       |       |       |   |
|   |   |   |   ----|   |   ----|   |   --------|   |   ----------------------------|   |   ----|   |
|   |       |   |   |       |   |       |           |   |       |                       |   |       |
|   |   ----|   |   --------|   --------|   --------|   |   |   |   ----|   |   --------|   |   |   |
|   |       |   |       |       |               |           |   |   |   |   |   |           |   |   |
|   --------|   |   |   |   |   ------------|   |   --------|   |   |   |   ----|   --------|   |   |
|                   |       |                   |           |           |                       |   |
----------------------------------------------------------------------------------------------------- 🚪 