----------------------------------------------------------------------------------------------------|
|   |                   |   |                   |                                   |   |           |
|   |   ------------|   |   |   |   --------|   ----|   ------------------------|   |   |   |   ----|
|       |           |   |   |   |           |       |       |           |           |       |       |
--------|   ----|   |   |   |   --------|   ----|   ----|   ----|   |   |   ------------|   ----|   |
|           |   |   |   |       |       |       |       |       |   |   |   |           |       |   |
|   --------|   |   |   |   ----|   |   ----|   ----|   ----|   |   |   |   ----|   |   --------|   |
|   |           |       |           |   |       |   |   |       |   |       |       |       |       |
|   |   |   |   ------------------------|   ----|   |   |   ----|   --------|   --------|   |   |   |
|   |   |   |   |                       |       |           |       |           |       |       |   |
|   |   |   |   ----|   ------------|   |   |   |   --------|   ----|   --------|   |   --------|   |
|   |   |   |           |       |       |   |   |   |       |   |       |       |   |           |   |
|   ----|   ------------|   |   |   --------|   ----|   |   |   ----|   |   ----|   ----|   ----|   |
|       |           |       |   |           |           |   |           |       |   |   |       |   |
----|   |   ----|   |   ----|   --------|   ------------|   ------------|   |   |   |   ----|   |   |
|       |       |   |       |       |   |                   |       |       |   |           |   |   |
|   ----|   ----|   |   |   ----|   |   --------------------|   ----|   ----|   ----|   ----|   |   |
|   |       |       |   |   |   |       |           |   |               |       |       |       |   |
|   --------|   --------|   |   ----|   |   ----|   |   |   ------------|   ----|   ----|   ----|   |
|           |       |       |       |       |           |               |           |       |       |
--------|   |   |   |   ----|   |   |   ------------|   ------------|   ------------|   ----|   ----|
|   |       |   |   |   |       |       |           |   |       |       |           |       |   |   |
|   |   --------|   |   ----------------|   ----|   ----|   |   |   --------|   |   ----|   |   |   |
|       |           |       |               |       |       |   |               |   |   |       |   |
|   --------|   ----|   |   |   ------------|   ----|   ----|   ----------------|   |   --------|   |
|               |       |                   |               |                                       |
----------------------------------------------------------------------------------------------------- 🚪 