----------------------------------------------------------------------------------------------------|
|       |   |                       |                           |                           |       |
----|   |   |   ----|   --------|   ----|   ----------------|   |   ------------|   ----|   |   |   |
|   |   |           |           |           |                   |   |           |       |       |   |
|   |   |   ----------------|   --------------------------------|   ----|   |   ----|   --------|   |
|       |       |           |   |       |                           |       |   |   |       |   |   |
|   --------|   |   ----|   |   |   |   |   ------------------------|   ----|   |   ----|   |   |   |
|       |       |   |       |       |       |                   |           |           |   |       |
----|   --------|   |   ----|   ------------|   ----|   ----|   |   ----|   ------------|   |   ----|
|   |               |   |       |           |       |       |   |   |       |           |   |   |   |
|   ----------------|   |   --------|   |   --------|   |   ----|   |   |   |   ----|   |   |   |   |
|                   |   |       |       |           |   |           |   |   |   |       |   |       |
|   --------|   |   |   ----|   |   ------------|   --------|   ----|   ----|   |   ----|   ----|   |
|   |           |   |   |   |   |           |   |           |       |   |       |           |   |   |
----|   --------|   |   |   |   --------|   |   --------|   --------|   |   ----------------|   |   |
|       |       |   |   |                   |                       |   |       |               |   |
|   ----|   |   ----|   --------|   ----------------------------|   |   ----|   --------|   ----|   |
|           |       |           |   |                       |               |           |           |
|   ------------|   --------|   ----|   ----------------|   ------------|   --------|   |   --------|
|   |           |           |       |   |               |       |               |       |   |       |
|   |   ----|   ----|   --------|   |   ----|   |   --------|   |   ------------|   ----|   |   ----|
|       |   |       |           |   |       |   |           |   |   |       |       |       |       |
--------|   ----|   ----|   |   |   ----|   |   --------|   |   ----|   |   |   ----|   ----|   |   |
|               |   |   |   |   |           |           |   |   |       |   |   |       |       |   |
|   ----|   ----|   |   |   ------------------------|   |   |   |   ----|   |   |   ------------|   |
|       |               |                               |           |           |                   |
----------------------------------------------------------------------------------------------------- 🚪 